000000000000000000000000000000
000000000000000000000000000000
000000000000000000000000000000
00000000CC00000000000000000000
000000022222000000000000000000
C000000000000000000000000C0000
220000000S000CCC02200000022S00
112222222222222221100002211200
111111111111111111100001111100
111111111111111111100000110000
111111111111111111100000100000
111111111111111111100000100000
111111111111111111100000000000